[MapData]:

 
49,50,74,72,48,520,520,520,520,520,520,520,520,73,48,73,50,50,72,50,73,49,74,73,50,73,49,72,72,73,50,73,50,73,50,49,72,74,50,72,72,50,72,74,48,48,50,74,48,50,49,48,520,520,520,50,74,73,73,73
74,73,74,72,74,520,520,520,520,520,520,520,520,74,73,49,50,50,50,49,74,48,73,50,72,50,74,49,49,48,48,74,72,50,73,73,73,49,73,49,48,49,49,72,73,72,74,73,74,74,50,50,520,520,520,49,49,49,73,48
49,50,50,72,72,520,520,520,520,520,520,520,520,520,520,520,520,520,520,520,520,520,520,520,520,520,520,520,520,520,520,520,520,520,520,520,520,520,520,520,520,520,520,520,520,520,520,520,520,520,520,520,520,520,520,49,48,48,49,74
49,520,520,520,520,520,520,48,48,73,73,48,48,520,520,520,520,520,520,520,520,520,520,520,520,520,520,520,520,48,49,72,48,73,72,520,520,520,520,520,49,50,48,50,73,50,74,48,48,72,72,520,520,520,520,74,48,49,74,73
48,520,520,520,520,520,520,72,49,49,49,72,73,49,49,520,520,520,520,520,520,520,520,520,520,520,520,520,520,49,73,48,73,73,49,520,520,520,520,520,49,49,73,73,72,72,74,48,48,73,49,520,520,520,520,74,49,48,48,50
73,520,520,520,520,520,520,520,520,520,520,520,520,520,520,520,520,520,520,520,520,520,520,520,520,520,520,520,520,49,49,73,73,48,73,520,520,520,520,520,73,50,72,74,49,49,49,48,72,48,50,520,520,520,520,73,49,73,74,48
73,520,520,520,520,520,520,520,520,520,520,520,520,520,520,520,520,520,520,520,520,520,520,520,520,520,520,520,520,49,73,72,72,49,48,520,520,520,520,520,49,48,49,74,50,50,72,49,73,49,73,520,520,520,520,73,74,74,49,50
48,520,520,520,520,520,520,520,520,520,520,520,229,229,229,229,229,229,520,520,520,520,520,520,520,520,520,520,520,49,49,48,73,72,49,520,520,520,520,520,73,49,48,50,49,73,48,73,50,48,73,520,520,520,520,73,73,50,73,73
72,520,520,520,520,520,520,520,520,520,520,229,229,229,229,229,229,229,229,520,520,520,520,520,520,520,520,520,520,48,73,72,73,48,49,520,520,520,520,520,48,73,73,74,74,74,72,50,72,72,72,520,520,520,520,48,73,72,50,50
48,520,520,520,520,520,520,496,496,496,229,229,229,229,229,229,229,229,229,229,496,496,496,520,520,520,520,520,520,72,72,48,73,72,72,520,520,520,520,520,520,520,520,520,520,520,520,520,520,520,520,520,520,520,520,520,520,520,520,520
74,520,520,520,520,520,520,496,496,229,229,229,523,523,523,523,523,229,229,229,229,496,496,520,520,520,520,520,520,49,72,49,49,48,48,520,520,520,520,520,520,520,520,520,520,520,520,520,520,520,520,520,520,520,520,520,520,520,520,520
49,520,520,520,520,520,520,496,229,229,229,229,523,262,262,262,523,229,229,229,229,229,496,520,520,520,520,520,520,48,72,48,48,72,48,520,520,520,520,520,520,520,520,520,520,520,520,520,520,520,520,520,520,520,520,520,520,520,520,520
49,520,520,520,520,520,520,229,229,229,229,229,523,262,262,262,523,229,229,229,229,229,229,520,520,520,520,520,520,48,72,48,72,73,73,520,520,520,520,520,520,520,520,520,520,520,520,520,520,520,520,520,520,520,520,520,520,520,520,520
73,520,520,520,520,520,520,229,229,229,229,229,523,262,262,262,523,229,229,229,229,229,229,520,520,520,520,520,520,49,72,73,73,72,49,520,520,520,520,520,520,520,520,520,520,520,520,520,520,520,520,520,520,520,520,520,520,520,520,520
72,520,520,520,520,520,520,229,229,229,229,229,523,262,262,262,523,229,229,229,229,229,229,520,520,520,520,520,520,72,72,72,49,49,49,520,520,520,520,520,520,520,520,520,520,520,520,520,520,520,520,520,520,520,520,520,520,520,520,520
73,520,520,520,520,520,520,229,229,229,229,229,229,229,229,229,229,229,229,229,229,229,229,520,520,520,520,520,520,72,72,49,73,48,48,520,520,520,520,520,72,520,49,72,72,49,48,74,48,74,72,49,520,73,49,74,50,50,74,73
50,520,520,520,520,520,520,229,229,229,229,229,229,229,229,229,229,229,229,229,229,229,229,520,520,520,520,520,520,48,72,48,73,72,72,520,520,520,520,520,72,72,50,49,50,74,49,74,50,50,74,48,520,49,48,48,74,49,73,72
72,520,520,520,520,520,520,229,229,229,229,229,229,229,229,229,229,229,229,229,229,229,229,520,520,520,520,49,72,73,48,48,49,48,48,520,520,520,520,520,520,50,50,73,74,74,48,50,48,49,74,73,520,48,49,74,48,48,49,50
73,520,520,520,520,520,520,496,229,229,229,229,229,229,229,229,229,229,229,229,229,229,496,520,520,520,520,49,72,49,73,48,73,72,49,520,520,520,520,520,72,48,48,50,72,49,74,49,49,49,50,74,520,48,49,48,74,48,72,73
49,520,520,520,520,520,520,496,496,229,229,229,229,229,229,229,229,229,229,229,229,496,496,520,520,520,520,73,73,49,48,49,48,49,72,520,520,520,520,520,72,74,48,74,74,74,73,73,73,50,72,520,520,48,50,48,74,72,49,50
73,520,520,520,520,520,520,496,496,496,229,229,229,229,229,229,229,229,229,229,496,496,496,520,520,520,520,520,520,520,520,520,520,520,520,520,520,520,520,520,49,48,74,72,72,48,72,49,72,73,48,520,50,73,72,72,49,72,73,50
48,520,520,520,520,520,520,520,520,520,520,229,229,229,229,229,229,229,229,520,520,520,520,520,520,520,520,520,520,520,520,520,520,520,520,520,520,520,520,520,520,50,73,48,72,50,72,48,49,73,49,520,50,48,48,72,74,72,73,48
50,520,520,520,520,520,520,520,520,520,520,520,229,229,229,229,229,229,520,520,520,520,520,520,520,520,520,520,73,72,72,72,73,48,48,520,520,520,520,520,48,73,74,72,74,50,72,49,73,49,73,520,50,49,74,74,49,73,74,50
74,520,520,520,520,520,520,520,520,520,520,520,520,520,520,520,520,520,520,520,520,520,520,520,520,520,520,520,72,72,73,73,72,48,49,520,520,520,520,520,72,74,520,74,48,48,49,49,72,72,73,520,74,50,50,73,73,73,50,50
73,520,520,520,520,520,520,520,520,520,520,520,520,520,520,520,520,520,520,520,520,520,520,520,520,520,520,520,520,520,520,520,520,520,520,520,520,520,520,520,520,520,520,520,520,520,520,520,520,520,520,520,520,520,520,520,520,520,520,520
49,520,520,520,520,520,520,520,520,520,520,520,520,520,520,520,520,520,520,520,520,520,520,520,520,520,520,520,520,520,520,520,520,520,520,520,520,520,520,520,520,520,520,520,520,520,520,520,520,520,520,520,520,520,520,520,520,520,520,520
72,520,520,520,520,520,520,49,520,520,520,520,520,520,520,520,520,520,520,520,520,520,520,520,520,520,520,520,520,520,520,520,520,520,520,520,520,520,520,520,520,520,520,520,520,520,520,520,520,520,520,520,520,520,520,520,520,520,520,520
72,520,520,520,520,520,520,48,72,73,72,72,72,49,48,73,73,520,520,520,520,520,520,520,520,520,520,520,520,520,520,520,520,520,520,520,520,520,520,520,520,520,520,520,520,520,520,520,520,520,520,520,520,520,520,520,520,520,520,520
49,520,520,520,520,520,520,48,72,73,73,49,73,49,73,48,48,520,520,520,520,520,520,520,520,520,520,520,520,520,520,520,520,520,520,520,520,520,520,520,520,520,520,520,520,520,520,520,520,520,520,520,520,520,520,520,520,520,520,520
49,520,520,520,520,520,520,49,74,48,48,74,48,48,74,73,49,520,520,520,520,520,520,520,520,520,520,520,520,520,520,520,520,520,520,520,520,520,520,520,520,520,520,520,520,520,520,520,520,520,520,520,520,520,520,520,520,520,520,520
48,520,520,520,520,520,520,50,72,50,48,50,48,73,50,49,49,520,520,520,520,520,520,520,520,520,520,520,520,520,520,520,520,520,520,520,520,520,520,520,520,520,520,520,520,520,520,520,520,520,520,520,520,520,520,520,520,520,520,520
50,520,520,520,520,520,520,72,73,74,73,74,50,74,48,74,73,73,48,73,73,48,49,49,48,49,72,48,48,49,48,72,48,48,49,72,48,74,50,49,49,72,49,72,74,49,72,48,73,73,48,72,520,50,73,49,520,520,520,520
73,520,520,520,520,520,520,73,48,74,49,50,50,73,50,74,49,49,73,48,48,73,49,49,48,72,48,73,73,48,49,73,49,73,49,73,72,72,49,74,48,49,50,73,72,49,72,74,50,50,50,73,520,49,72,50,520,520,520,520
49,520,520,520,520,520,520,50,48,72,49,48,74,48,73,50,48,49,72,48,73,72,48,73,49,73,49,72,48,72,48,73,49,48,48,49,48,48,73,74,49,49,73,74,48,72,74,74,48,73,72,520,520,72,72,73,520,520,520,520
72,520,520,520,520,520,520,72,48,74,73,74,74,74,73,72,49,72,50,74,73,49,48,73,49,49,48,73,73,49,49,72,49,49,49,48,72,50,49,50,74,49,48,74,49,48,50,74,49,74,48,520,72,73,48,72,520,520,520,520
74,520,520,520,520,520,520,72,72,48,73,50,73,74,48,49,48,74,50,50,50,48,72,72,48,73,50,74,48,72,73,73,48,50,73,74,49,48,49,49,49,50,49,50,48,48,72,74,74,48,48,520,48,48,49,49,520,520,520,520
72,520,520,520,520,520,520,73,50,72,49,73,48,48,72,73,49,72,73,49,50,48,74,73,49,72,50,72,72,50,50,74,48,74,73,74,50,50,50,48,49,74,73,72,49,48,48,73,73,72,520,520,50,49,74,72,520,520,520,520
50,520,520,520,520,520,520,49,72,73,48,50,74,48,74,49,73,49,72,72,72,74,49,72,49,72,50,72,72,48,48,73,48,49,48,50,520,520,520,520,520,520,520,520,520,520,520,520,520,520,520,50,48,49,48,50,520,520,520,520
73,520,520,520,520,520,520,74,49,48,73,72,50,72,49,72,49,72,49,49,74,520,520,520,520,520,520,520,520,520,520,520,520,520,520,520,520,74,50,73,72,50,74,73,72,48,74,49,74,73,73,72,74,49,50,48,520,520,520,520
74,520,520,520,520,520,520,50,49,48,49,48,72,48,50,49,73,72,50,520,520,520,74,49,73,48,50,50,73,49,73,73,49,74,49,74,72,72,74,74,48,50,48,48,49,50,73,74,73,50,48,50,48,74,73,48,520,520,520,520
50,520,520,520,520,520,520,520,520,520,520,520,520,520,520,520,520,520,520,520,72,48,73,49,49,48,49,74,74,49,48,74,50,72,74,73,49,74,74,49,74,73,74,74,50,72,72,72,48,49,73,74,50,48,50,73,520,520,520,520
48,520,520,520,520,520,520,520,520,520,520,520,520,520,74,72,50,73,50,49,72,48,74,50,48,73,72,48,72,50,50,49,49,49,49,74,73,48,74,74,50,73,50,50,74,72,48,50,72,74,49,72,73,74,49,74,520,520,520,520
74,520,520,520,520,520,520,520,520,520,520,520,520,520,49,49,48,72,49,73,50,74,49,50,73,48,72,50,72,49,72,73,74,72,50,73,72,49,49,49,48,74,74,73,72,72,73,74,73,72,49,72,48,49,49,74,520,520,520,520
48,49,74,74,520,520,520,520,520,520,520,520,520,50,48,74,49,50,73,73,49,73,73,48,49,73,74,50,49,72,49,74,48,73,73,49,50,50,72,73,48,72,50,72,72,73,74,49,50,48,74,49,72,49,73,73,520,520,520,520
48,74,74,73,520,520,520,520,520,520,520,520,520,49,73,72,48,74,50,48,72,72,72,48,74,50,74,48,50,50,73,49,74,50,50,50,49,72,48,72,72,48,73,73,48,72,49,74,49,72,74,48,48,72,72,49,520,520,520,520

